
NO ./textures/black.jpeg

C   220,111,1

SO    ./textures/black.jpeg

F   25,250,0

WE ./textures/black.jpeg     

EA     ./textures/black.jpeg

        1111111111111111111111111    
        1000000000110000000000001   
        1011000001110000000000001
        1001000000000000000000001
111111111011000001110000000000001
10000000001100000111011111111111
11110111111111111111011111111111
11110111111111111111S11111111111
1111011111111101110000001001
11110111111111011101010010001
11110111111111111111111111111
1100000011010101110000001001   
10000000000000001100000010001
10000000000000000101010000001
11000001110110111101111010111
1111011111101011 1111 10001   
11111111 1111111 1111 1111111