111111111111111111111111111111111111111
100000000000000000000100000000000000001
110000000000000000000000000000001000001
1P0000000000001000000000000000000000001
100000000000001000000000000000000000001
100000000100000000100000010000000000001
100000000000000000000000000000000000001
100000000000000000000000000000000000001
100000000000000100000000000000000000001
111111111111111111111111111111111111111