EA ./textures/wall_texters/pl.png
SO ./textures/wall_texters/33.png
NO ./textures/wall_texters/kl.png
WE ./textures/wall_texters/wall.png

C 200,255,225
F 10,0,10

    111111111111111111111111111111111111111111111111111111111111111111111111111111111111111111111111111111111111111111111111111111111111111111111111111111111111111111111111111111
    10000000000000000001100000000000000000000000001100000000000000000000000001100000000000000000000000001100000000000000000000000001100000000000000000000000001100000001
    10000100001111111000000000000000000000000000001100000000000000000000000001100000000000000000000000001100000000000000000000000001100000000000000000000000001100000001
    100000000111     1111111111111111111111111111111111111111111111111111111111111111111111111111111111111111111111111111111111111111111111111111111111111111111111111111111111111
111111110011110111111111 1111    
10000000000000000001100010001    
10000100000100001000000100001    
10000000011100000011100000001    
1000000S001110000001110000001    
11111111111111111111111111111    