NO ./textures/wall1.png
EA ./textures/wall.png
WE ./textures/wall.png
SO ./textures/wall.png

F 100,55,255
C 55,233,255

11111111111111111111111111111
10000000000000000011100000001
10000100000010000000000000001
100000000100000000N0000000001
11111111111111111111111111111