EA ./textures/wall.png
WE ./textures/wall.png
NO ./textures/wall1.png
SO ./textures/wall.png

F  25,205,225
C   254,233,255

11111111111111111111111111111   
10000000000000000001100000001   
10000100000010000101000000001
100000000000000000011100000001
100001000000100001010000000011
1000000000000000000110001001
1000N100000010000101000010001
100000000001000000011100000001
10000000001 10000001 100000001
11111111111 11111111 111111111