EA   ./textures/wall.png
F               0,0,0
WE   ./textures/wall.png
SO   ./textures/wall.png
C               25,23,250

NO   ./textures/wall1.png






            11111111111111111111111111111
            10000000000000000001100000001     
            10000100000111111101000000001   1
            10000000011    1111111111111  111
1111111111111101000000111111               
10000000000000000001100010001               
10000100000100001001000100001               
100000000S1110000001110000001                
10000000001 10000001 10000001                
11111111111 11111111 11111111