NO ./textures/black.jpeg
EA ./textures/black.jpeg
WE ./textures/black.jpeg
SO ./textures/black.jpeg

F 55,32,25
C 55,23,255

1111111111111111111
1000000000000000001
1000000000000000001
1000000001000000001
1000000000000000001
1000010000001000001
1000000001000000001
1000000000000000001
1000001000000000001
1000000000000000001
1000000000001000001
1000000000001000001
10000000000000000N1
1111111111111111111