NO ./textures/black.jpeg
EA ./textures/black.jpeg
WE ./textures/black.jpeg
SO ./textures/black.jpeg

F   0,250,0
C   220,111,1

11111111
10000001
100000N1
11111111