NO ./textures/wall.png
EA ./textures/wall.png
WE ./textures/wall.png
SO ./textures/wall.png

F 39,102,250
C 55,233,255

11111111111111111111111111111111111111
10000000000000000011100000000001111111111
100001000000100000000000000011100000000001111
10000000010000000000000000001111111111111
1000000000000000001111000000000011111
1000001000000000N01111110000000000111
10000000000000000000000000001111111111111
1000000000001000000000000111000000000011111111
1000000000001000001111111000000000011111
100000000000000000110000000000111111111
100000000000100000000000000010000000000111111
100000000000100000111111000000000000000111
100000000000100000000000000001111111111
10000000000000000011111000000000011111111
11111111111111111111111111111111111111