NO ./textures/black.jpeg
EA ./textures/black.jpeg
WE ./textures/black.jpeg
SO ./textures/black.jpeg

F 020,250,0
C 220,111,1

1111111111111111111
1000000000000000001
1000000000000000001
1000000000000000001
1000000000000000001
1000000000000000001
1000000000000000001
100000000000000000N1
111111111111111111111