NO ./textures/black.jpeg
SO ./textures/black.jpeg
WE ./textures/black.jpeg
EA ./textures/black.jpeg

C 220,111,1
F 25,250,255     

        1111111111111111111111111
        1000000000110000000000001
        1011000001110000000000001
        1001000000000000000000001
111111111011000001110000000000001
10000000001100000111011111111111
111111111111111111111111111111111111111111111111
11111111111111111111N11111111111111111111111111
11110111111111011100000010001
11110111111111011101010010001
11000000110101011100000010001   
10000000000000001100000010001
10000000000000000101010000001
11000001110110111101111010111
11110111 1110101101111010001   
11111111 1111111 1111 1111111