
C   220,111,1
NO ./textures/black.jpeg

WE ./textures/black.jpeg

F    25,     250,     0

EA          ./textures/black.jpeg

SO   ./textures/black.jpeg

111111111111111111111111111111
100000000011000000N000001
10000000001100000000000001111
10000000001100000000000011111
10000000001100000000000111111
10000000001100000000000111111
10000000001100000000000111111
11111111100000111111111111111
111111111111111111111111111111
111111111111111111111111111111
111111111111111111111111111111