NO ./textures/black.jpeg
EA ./textures/black.jpeg
WE ./textures/black.jpeg
SO ./textures/black.jpeg

F 39,102,250
C 55,233,255

1111111111111111111
1000100000010000001
10000000100000000N1
1111111111111111111