EA ./textures/wall_texters/bob.png
SO ./textures/wall_texters/bob2.png
NO ./textures/wall_texters/braz.png
WE ./textures/wall_texters/braz2.png
  
C 21,221,255
F 21,1,1
   
   
    
    
11111111
1111N1111
1000000001
100000001
11111111
       
        
         
111111111111
111111111
11111111111
11111111111
1111111111
111111111
111111111111
111111111
11111111111
11111111111
1111111111
111111111
111111111111
111111111
11111111111
11111111111
1111111111
111111111
111111111111
111111111
11111111111
11111111111
1111111111
111111111
111111111111
111111111
11111111111
11111111111
1111111111
111111111
111111111111
111111111
11111111111
11111111111
1111111111
111111111
111111111111
111111111
11111111111
11111111111
1111111111
111111111
111111111111
111111111
11111111111
11111111111
1111111111
111111111
111111111111
111111111
11111111111
11111111111
1111111111
111111111
111111111111
111111111
11111111111
11111111111
1111111111
111111111
111111111111
111111111
11111111111
11111111111
1111111111
111111111
111111111111
111111111
11111111111
11111111111
1111111111
111111111
111111111111
111111111
11111111111
11111111111
1111111111
111111111
111111111111
111111111
11111111111
11111111111
1111111111
111111111
111111111111
111111111
11111111111
11111111111
1111111111
111111111
111111111111
111111111
1111111111