EA ./textures/wall_texters/bob.png
SO ./textures/wall_texters/bob2.png
NO ./textures/wall_texters/braz.png
WE ./textures/wall_texters/braz2.png

C 21,221,255
F 21,1,1

111111111111 
1111N00000001
1000011000111
10000D0000111
1111111111111