EA ./textures/wall_texters/SAMPLE/wall_1.png
SO ./textures/wall_texters/SAMPLE/FLOOR_1A.PNG
NO ./textures/wall_texters/SAMPLE/PIPES_2B.PNG
WE ./textures/wall_texters/SAMPLE/CRATE_2M.PNG






C 200,220,255
F 20,0,0
111111111
100000001
100000001
1001D1001
100000001
100000N01
101110001
111111111