EA ./textures/wall.png
SO ./textures/wall.png
NO ./textures/wall1.png
WE ./textures/wall.png

C 5,95,255
F 2,255,01

    11111111111111111111111111111
    10000000000000000001100000001
    10000100000111111100000000001   
    100000000111     111111111111
11111111001111011111111111111     
10000000000000000001100010001    
1000010000010001000D00100001       
10000000011100000011100000001      
1000000E001110000001110000001    
11111111111111111111111111111       