EA ./textures/wall_texters/SAMPLE/wall_1.png
SO ./textures/wall_texters/SAMPLE/FLOOR_1A.PNG
NO ./textures/wall_texters/SAMPLE/PIPES_2B.PNG
WE ./textures/wall_texters/SAMPLE/CRATE_2M.PNG

C 200,220,255
F 20,0,0

1111111111111111
1000000000000001
1000000000000001
1001D10000000001
1000N00000000001
1000000001D10001
1011100000000001
1111111111111111