EA ./textures/wall_texters/SAMPLE/bob.png
SO ./textures/wall_texters/SAMPLE/braz.png
NO ./textures/wall_texters/SAMPLE/braz3.png
WE ./textures/wall_texters/SAMPLE/bob2.png
C 200,220,255
F 47,32,1

1111111111111111
100001D100000001
1000000000000001
1001110000100001
1000000000000001
1000000001010001
10111000000D0001
1000000001010001
10111000000D0001
1000000001010001
10111000000D0001
1000000001010001
10111000000D0001
1000000001010001
10111000000D0001
1000000001010001
10111000000D0001
1000000001010001
10111000000D0001
1000000001010001
1011100N000D0001
1111111111111111